824 12843 2313 -44 891 669 137 139
922 -745 908 90 -127 -507 863 609
1242 -24 774 152 504 92 549 322
401 152 477 5316 -11 -540 466 137
843 -659 -153 44 210 129 250 1822
912 1241 209 924 1057 513 417 -1183
405 -223 740 -934 -84 -1325 -608 836
-419 1766 108 1385 325 -272 -600 407
-1079 -1640 1680 556 1147 -117 1164 385
1241 206 1382 113 285 -286 1115 113
423 75 599 1153 14342 -329 1262 466
1484 316 1895 -320 555 -114 -10594 716
-95 360 -511 27 1563 4466 953 1566
-1373 5918 1592 1084 2102 -626 -67 -243
-170 5 -273 -176 67 -152 526 315
5419 -229 -429 100 1197 3730 1390 -59
484 1849 422 245 976 3193 226 -138
804 -248 -1722 815 285 1100 -52 473
-102 105 -50 732 1305 539 529 -260
-69 1117 576 812 1077 726 251 1983
-76 1636 -695 836 254 -53 651 9832
1200 -21 1344 -2587 102 464 -146 -373
3 367 -8 1556 2121 1950 258 32767
-1011 867 1168 763 21 1297 512 4579
136 -261 294 1034 59 1619 507 279
681 6437 182 781 1787 422 -1425 13097
2741 -425 1709 -187 587 -69 615 535
789 318 -34 646 2821 -430 396 237
916 510 948 1078 347 -1102 199 450
433 691 146 342 21517 1110 406 -237
26719 -285 -279 -286 2878 452 472 737
306 749 -183 -135 813 -196 923 286
370 675 474 23770 -260 -451 874 1751
615 545 1310 -671 34 -346 502 1144
1145 874 -155 -50 -767 83 387 -574
925 778 234 -53 -2146 932 313 96
721 474 13449 1181 1420 650 -1334 -7
1045 220 949 -330 475 471 446 561
-347 5 -662 1161 86 468 938 485
105 1493 315 8114 197 -884 718 956
811 -3419 -483 3009 137 227 354 -330
825 -46 516 -169 -164 211 22 -49
-1057 -803 521 -344 -291 -846 1068 -79
339 1121 -726 341 489 745 800 642
-1023 843 862 28 403 661 1198 694
173 1252 503 357 -225 -78 442 -33
846 546 1072 137 11327 -1199 331 286
325 1408 663 -189 -1200 226 -1577 552
-187 168 786 689 -1039 10121 358 6422
-962 6513 453 -116 -109 479 636 1151
877 1289 109 1363 839 1898 360 907
240 732 390 -277 -178 195 3544 1752
72 307 1068 -119 124 599 665 233
982 -150 445 1159 565 574 493 1210
1525 42 1 687 457 1063 451 379
-9220 643 753 622 -229 26 402 -334
-158 832 579 670 1105 -506 130 4698
249 -675 1022 971 136 -1035 390 -1672
-278 693 -1676 1537 780 510 705 -274
-722 1621 881 112 3318 910 -71 -264
-84 1651 179 -275 714 3044 664 1304
2377 9206 -25 -32 2881 -9 410 -1647
-1358 1192 643 -101 -207 139 -431 596
333 308 567 -534 867 1580 10 94
31 496 1516 0 1288 -216 53 330
-317 1023 1162 500 1251 793 1112 1084
28308 1143 -620 -383 2627 553 7387 1109
455 -3500 507 -270 23 -107 -390 -378
324 -65 159 23252 -148 100 473 2216
-562 887 -52 -41 451 1270 69 545
731 259 759 693 49 938 1681 133
1268 891 312 1169 -180 1463 7794 -145
85 8468 -60 43 -577 1508 669 -460
306 405 1295 110 596 761 -131 38
425 1551 212 417 111 262 -497 0
838 664 -333 4238 -136 -39 280 -208
-433 -175 12 938 739 274 190 -843
105 -962 226 210 165 248 -740 647
-699 1384 407 296 609 -811 62 5867
1486 2823 -206 447 34 78 364 -133
-280 -672 1054 -892 929 1185 253 90
-45 1454 51 -71 -1238 971 -105 733
1008 -1188 1131 990 462 -185 1013 -831
488 824 12 375 1136 578 -298 1499
477 -217 790 661 612 -428 44 1243
518 7992 1484 248 390 426 735 565
201 -965 513 307 659 -1269 -28 510
1287 -544 410 536 19 -55 2339 -518
483 3327 353 606 -131 5548 -181 192
945 637 -569 949 -1866 94 -22 808
1104 -241 1175 1286 -350 1192 922 538
-537 602 103 445 -89 271 -83 190
-553 757 550 -228 706 -636 -122 5816
797 613 49 498 484 979 91 -545
-670 881 517 656 1914 -409 1057 32767
-894 771 968 466 1232 330 -311 1209
682 -204 308 468 238 1194 -499 1218
-567 3235 5039 1102 3855 102 621 12322
161 738 490 365 91 -215 392 -31
509 19 130 -1481 2175 -1200 1 262
-24 1099 -112 490 -120 -511 -343 511
963 407 -186 -620 1700 758 -142 2028
-31 504 -318 108 1310 -297 63 -1034
-568 831 596 940 388 775 478 -1696
219 -1294 959 25326 12 1238 849 339
-216 667 520 -43 604 288 6 -1365
817 631 298 88 -626 859 -112 -315
-202 830 652 392 -373 1571 551 428
-858 4517 5377 -745 -868 1203 27 129
1075 60 -386 47 508 -199 -700 584
-1088 -1886 348 1265 2474 240 273 -323
-421 -122 -269 4646 890 1225 250 537
789 -565 -152 -2197 336 1128 186 308
-136 43 -109 51 405 777 -255 99
194 -147 37 766 748 620 1307 580
1255 3272 355 948 686 862 635 -6
571 618 -1739 -122 -37 668 2058 1129
752 1540 730 1140 148 -44 884 -644
154 858 -292 463 -684 -553 1243 110
220 1411 -486 164 904 692 -1037 -1222
276 608 153 630 175 1403 822 4086
-173 3427 1744 716 -1360 352 273 -177
85 1 624 -187 745 291 -677 662
-1039 -269 801 -99 455 -679 2441 577
427 1700 1768 710 748 7629 325 557
447 726 920 158 -684 729 -202 1807
1242 -394 450 -27 -898 900 171 659
676 736 -363 1156 -12 230 690 551
1019 877 -460 228 160 -64 -17 4796
-49 498 437 -94 687 -50 -374 -415
109 151 -205 544 723 -413 -334 -3025
-202 206 153 -7 1470 637 1372 -1099
-170 1054 613 419 775 1679 73 1965
-819 1150 955 1321 1223 352 359 -736
-631 578 -156 -269 57 419 82 474
1009 299 116 378 -1130 558 -398 398
247 1149 99 918 5724 1974 134 505
409 429 607 1382 735 30 643 -407
8934 -350 375 423 904 357 -858 -1937
-386 -1008 -406 1101 -53 -235 764 -6
265 1192 1241 25307 608 -303 823 702
1221 614 18 -585 -227 880 -27 290
-18 742 63 339 315 439 5640 -135
-236 508 -195 -465 -39 -198 5947 325
